0  0  18 0  0  0  0  0  0  0  0  0  0  0  0  0  
0  0  2  0  0  0  0  0  0  0  0  0  0  0  0  0  
0  0  2  5  4  4  4  4  4  4  4  6  0  0  0  0  
0  10  10  1  0  0  0  0  0  0  0  2  0  0  0  0  
0  2  0  1  0  0  0  0  0  0  0  6  4  6  0  0  
0  6  4  5  0  0  0  0  0  0  0  0  0  2  0  0  
0  0  0  0  0  0  0  0  0  0  0  0  0  2  0  0  
0  0  10 8  8  8  8  8  8  8  8  8  8  10 0  0  
0  0  2  0  0  0  0  0  0  0  0  0  0  0  0  0  
0  0  2  0  0  0  64 64 64 0  0  0  0  0  0  0  
0  0  6  4  6  0  64 64 64 64 0  0  0  0  0  0  
0  0  0  0  2  0  0  64 64 64 0  0  0  0  0  0  
0  0  0  0  2  0  0  0  0  0  0  0  0  0  0  0  
0  0  0  0  6  4  4  4  4  4  4  4  4  6  0  0  
0  0  0  0  0  0  0  0  0  0  0  0  0  2  0  0  
0  0  0  0  0  0  0  0  0  0  0  0  0  32 0  0  
